NO ./textures/wood.xpm
EA ./textures/wood.xpm
SO ./textures/wood.xpm
WE ./textures/wood.xpm
DO ./textures/wood.xpm

F 250, 156,150

111111111111111111111111111111111111111111111111
100000000000000000010000000000000000000000000001
10000000N000000000010000000100100100000001000001
100000000000000000000000000001010000000000000001
111111111111111111111111111111111111111111111111

C 27, 210,200
