NO ./textures/redbrick.xpm
EA ./textures/colorstone.xpm
SO ./textures/redbrick.xpm
WE ./textures/redbrick.xpm
DO ./textures/woody.xpm

F 147, 159, 153
C 219, 213, 213

1111111
100N001
1000001
1111111
