NO ./textures/redbrick.xpm
EA ./textures/colorstone.xpm
SO ./textures/redbrick.xpm
WE ./textures/redbrick.xpm
DO ./text/wood.xpm

F 147, 159, 153
C 219, 213, 213

1111111
100N001
10002001
11111111
