NO ./textures/4.xpm
EA ./textures/1.xpm
SO ./textures/3.xpm
WE ./textures/2.xpm
DO ./textures/wood.xpm

F 15, 100, 0
C 27, 210, 227

                 111100001111111111111111111111111111111111111111
                 1001000001                                     1
                 1001111101                                     1
                 1001000001                                     1
11111    11111   1001000001                                     1
10001    1000111110011111111111                                 1
10001    1000000000000000000002                                 1
10001    1000000000000000000002                                 1
10001    10001111011111111000011111111111111111111111111111111111
10001    10001  1010000001000020000000000000000000000000000000001
10001    10001  1011111111000010000010000000000000000000001000001
10001111110001  1000000000000010010010011111111111111111001001001
10000000000001  1111101111000010010010000000000000000000001001001
10000000000001      101111000010010011111111111111111111111001001
10000E00000001      100000000010010000000000000000000000000001001
10000000000001      100000000010011111111111111111111111111111001
12111111111110      111111111110000000000000000000000000000000001
100000001           100000000112211111111111111111111111111111101
111111001111100000001000000002                                101
100000001000100000000000000001                                101
100000000000000000000000000001                                101
11111111110000000001111111111112211111111111111111111111111111101111111
10000000010000000001000000000100000000000000000200000000000000000000001
10000000010000000001000000000200111111111111111100000000000000000000001
10000000010000000001000000000200000000000010000000000000000011110000001
1000000001000000000100000000010111111111111000000000000000001  10000001
1211111111000000000111111000010100000000000001100000000000001  10000001
1010000000011110000000001000010100000000000001100000111111111  10000001
10100000000111100000000010000101000000000000011111111          11111111
10100000000111100000000010000101001111111111111111111211111111111111111
10100000000111100000000011111101000000000000000000000000000000000000001
10121111111101111111100000000001010001000100010001000100010001000100101
10101111111111111111111111111111000100010001000100010001000100010001001
10101000000000000100000000000010010001000100010001000100010001000100011
10101111110111110101111111101111000100010001000100010001000100010001001
10101000000101000001000000000010010001000100010001000100010001000100011
10101011111101011101011111111111000100010001000100010001000100010001001
10101000000000010101000000000020010001000100010001000100010001000100011
10000011111111110101011111111111000100010001000100010001000100010001001
10101000001000010101000000000010010001000100010001000100010001000100011
10111111111111010101111111111111000100010001000100010001000100010001001
10000001000000000000000000000010010001000100010001000100010001000100011
11111111111111111111111111111111111111111111111111111111111111111111111
