NO ./textures/wood.xpm
EA ./textures/colorstone.xpm
SO ./textures/greystone.xpm
WE ./textures/redbrick.xpm

F 0, 156, 8
C 27, 210, 227

                 111100001111111111111111111111111111111111111111
                 1001000001                                     1
                 1001111101                                     1
                 1001000001                                     1
11111    11111   1001000001                                     1
10001    1000111110011111111111                                 1
10001    1000000000000000000001                                 1
10001    1000000000000000000001                                 1
10001    10001111011111111000011111110000000000000000000001111111
10001    10001  1010000001000000000000000000000000000000000000001
10001    10001  1011111111000010000010000000000000000000001000001
10001111110001  1000000000000010010010011111111111111111001001001
10000000000001  1111101111000010010010000000000000000000001001001
10000000000001      101111000010010011111111111111111111111001001
10000E00000001      100000000010010000000000000000000000000001001
10000000000001      100000000010011111111111111111111111111111001
10111111111111      111111111110000000000000000000000000000000001
100000001           100000000011111111111111111111111111111111101
1111110011111000000010000000000                               101
10000000100010000000000000000111                              101
10000000000000000000000000000101                              101
11111111110000000001111111111101111111111111111111111111111111101111111
10000000010000000001000000000100000000000000000000000000000000000000001
10000000010000000001000000000000111111111111111100000000000000000000001
10000000010000000001000000000000000000000010000000000000000000110000001
1000000001000000000100000000010111111111111000000000000000001  10000001
1011111111000000000111111000010100000000000001100000000000001  10000001
1010000000011110000000001000010100000000000001100000111111111  10000001
1010000000011110000000001000010100000000000001111111100000000  11111111
10100000000111100000000010000101001111111111111111111111111111111111111
10100000000111100000000011111101000000000000000000000000000000000000001
10101111111101111111100000000001010001000100010001000100010001000100101
10101111111111111111111111111111000100010001000100010001000100010001001
10101000000000000100000000000010010001000100010001000100010001000100011
10101111110111110101111111101111000100010001000100010001000100010001001
10101000000101000001000000000010010001000100010001000100010001000100011
10101011111101011101011111111111000100010001000100010001000100010001001
10101000000000010101000000000000010001000100010001000100010001000100011
10000011111111110101011111111111000100010001000100010001000100010001001
10101000001000010101000000000010010001000100010001000100010001000100011
10111111111111010101111111111111000100010001000100010001000100010001001
10000001000000000000000000000010010001000100010001000100010001000100011
11111111111111111111111111111111111111111111111111111111111111111111111
