NO ./textures/wood.xpm
EA ./textures/colorstone.xpm
SO ./textures/wood.xpm
WE ./textures/wood.xpm

F 18, 176, 12
C 27, 210, 227

                 11110000
                 100100000
                 100111110
                 100100000
11111    11111   100100000
10001    1000111110011111111111
10001    1000000000000000000001
10001    1000000000000000000001
10001    1000111101111111100001
10001    10001  101000000100001
10001    10001  101111111100001
10001111110001  100000000000001
10000000000001  111110111100001 
10000000000001      10111100001
10000E00000001      10000000001
10000000000001      10000000001
10111111111111      11111111111
100000001           10000000001
1111110011111111111110000000001
10000000100010000000000000000111
10000000000000000000000000000101
11111111110000000001111111111101
11111111110000000001111111111101
11111111110000000001111111111101
11111111110000000001111111111101
11111111110000000001111111111101
11111111110000000001111111111101
11000000000111100000000011111101
11000000000111100000000011111101
11000000000111100000000011111101
11000000000111100000000011111101
11111111111101111111100000000001
11111111111111111111111111111111
