NO ./textures/wood.xpm
EA ./textures/colorstone.xpm
SO ./textures/wood.xpm
WE ./textures/wood.xpm
DO ./textures/wood.xpm

F 0, 156, 8
C 27, 210, 227

111111111111111111111111111111111111111111111111
100000000000000000010000000000000000000000000001
101000001000010000101000010000100000000000000001
101100000100001000010000100001110000000000000001
101110000010000100000001000010101000000000000001
101011000001000010000010000100100100000000000001
101001100000100001000100001000100010000000000001
101000110000010000101000010000100101000000000001
101000011000001000010000100000101000100000000001
101000001100000100000001000000110000010000000001
101000000110000010000010000000100000001000000001
101000000011000001000100000001010000000100000001
1010000000011000001N1000000010001000000010000001
101111111111110000010000000100100100000001000001
100000000000000000000000000001010000000000000001
111111111111111111111111111111111111111111111111
